___o______
__sbs_____
___p______
__o____o__
__o______o
___b______
___s______
__________
__________
__________