_____b____
__o__s_o__
____p_____
_____o____
____b_____
__s_______
__________
__________
__________
__________